11111111111111111111
1000C000010000001111
110110110C0001000111
110110101C0001000111
1101C011CC001E100111
1C01P00C00C00001C111
11111111111111111111